1111111111111111111
1000000000000000001
1000000011000000001
1000000011000000001
1000111111111110001
1000000000000000001
1111000021200001111
1000000222222200001
1000012105012101111
1000022155512200001
1111012100012101111
1000012222222100001
1111012111112101111
1000000001000000001
1000000000000000001
1000300000000000001
1011100111000000001
1010100101000000001
1011100111000000001
1010100100000000001
1111111111111111111
111