1111111111111111111
1000000001000000001
1011011101011101101
1000000000000000001
1011010111110101101
1000010001000100001
1111011121211101111
2221012222222101222
1111012115112101111
4222022155512202224
1111012111112101111
2221012222222101222
1111012111112101111
1000000001000000001
1011011101011101101
1001300000000001001
1101010111110101011
1000010001000100001
1011111101011111101
1000000000000000001
1111111111111111111
