1111111111111111111
1000000001000000001
1000000000000000001
1000000000000000001
1000000000000000001
1000000000000000001
1111011121211101111
2221012222222101222
1111012105012101111
4222022155512202224
1111012100012101111
2221012222222101222
1111012111112101111
1000000001000000001
1000000000000000001
1000300000000001001
1000000000000000001
1000000000000000001
1000000000000000001
1100000000000000011
1111111111111111111
